100,100
0000000000000000000000000000000000000000000000000000000000000000000000000000000000000000000000000000
1111000000000000000000000000000000000000000000000000000000000000000000000000000000000010000000000000
1111000000000000000000000000000000000000000000000000000000000000000000000000000000000110000000000000
1111000000000000000000000000000000000000000000000000000000000000000000000000000000000000000000000000
1110000000000000000000000000000000000000000000000000000000000000000000000000000000000101000000000000
1110001000000000000000000000000000000000000000000000000000000000000000000000000010111011100000000000
1110000100000000000000000000000000000000000000000000000000000000000000000000000001111111100000000000
1110001100000000000000000000000000000000000000000000000000000000000000000000000001111111100000000000
1110101000000000000000000000000000000000000000000000000000000000000000000000000000001111100000000000
1110111100000000000000000000000000000000000000000000000000000000000000000000000000011111100000000000
1111111110000000000000000000000000000000000000000000000000000000000000000000000000011111100000000000
1111111110000000000000000000000000000000000000000000000000000000000000000000000000011111000000000000
1111111110000000000000000000000000000000000000000000000000000000000000000000000000111111000000000000
1111111110000000000000000000000000000000000000000000000000000000000000000000000101111111000000000000
1111111110000000000000000000000000000000000000000000000000000000000000000000000111111111000000000000
1111111111000000000000000000000000000000000000000000000000000000000000000000001111111111010000000000
1111111111000000000000000000000000000000000000000000000000000000000000111111111111111111011000000000
1111111110000000000000000000000000000000000000000000000000000000000001111111111111111111011010000000
1111111110000000000000000000000000000000000000000000000000000000001111111111111111111111110100000000
1111111110000000000000000000000000000000000000000000000000000001011111111111111111111110110100000000
1111111110000000000000000000000000000000000000000000000000000001111111111111111111111111110100000000
1111111110000000000000000000000000000000000000000000000000001111111111111111111111111110100001000000
1111111111000000000000000000000000000000000000000000000000011111111111111111111111111110011100000000
1111111111000000000000000000000000000000000000000000000000011000001111111111111111111111000000000000
1111111111000000000000000000000000000000000000000000000000110000001111111111111111001111101101100000
1111111111000000000000000000000000000000000000000000000001111100000111111111111110000111010101100000
1111111111000000000000000000000000000000000000000000000111100000001111111111111110000101010110100000
1111111110000000000000000000000000000000000000000000001000000010111111111111111000000000110111110000
1111111111000000000000000000000000000000000011111110001000000101000001111111111100100100111001110000
1111110010100000000001111000000000000000011111111111111100000000000000001111111111110000110000110000
1111110011110000000001111111111111100000111111111111111100001000000000000111111111110111100000110000
1111100011011000000000010111111111111111111111111111111100000000000000000001111111001111000011010000
1111100001110100000000000001111111111111111111111111111100000000000000000011001111100010000011110000
1111100000000000000001000000011111111111111111111111111000000000000000000000001110000000000011100000
1111000000000000000000000000000111111111111111111111100000000000000000000000111100000000000111100000
1111110000000000000000000000000011111111111111111111100000000000000000000000000000000011111111100000
1111101000000000000000000000000000111111111111111100000000000000000000000000000000001111111111100000
1111101000000000000000000000000000000111111111111000000000000000000000000000000000011111111111110000
1111100000000000000000000000000000000011111111110000000000000000000000000000000000000111111111110000
1111100000000000000000000000000000000000000111110000000000000000000000000000000000000011111111110000
1111101000000000000000000000000000000000000000000000000000000000000000000000000000000001111111110000
1111111000000000000000000000000000000000000000000000000000000000000000000000000000000001111111110000
1111111100000000000000000000000000000000000000000000000000000000000000000000000000000000111111110000
1111111100000000000000000000000000000000000000000000000000000000000000000000000000000000111111110000
1111111100000000000000000000000000000000000000000000000000000000000000000000000000000100000111100000
1111111110000000000000000000000000000000000000000000000001100100000000000000000000000110000000100000
1111111111000000000000000000000000000000000000000000001111111111100000000000000000000000000000000000
1111111111100000000000000000000000000000000000000000011111111111111100010100001100000000000000000000
1111111111100000000000000000000000000000000000000000011111111111111111111100000011000000000000000000
1111111111100000000000000000000000000000000000000000011111111111111110111100101110000000000000000000
1111111111100000000000000000000000000000000000000000011111111111111111000111110000000000000000000000
1111111111100000000000000000000000000000000000000000011111111111111111000011111000010000000000000000
1111111111100000000000000000000000000000000000000100111111111111111111001111111110111000000000000000
1111111111100000000000000000000000000001111000111111111111111111111100000101111101111100000001000000
1111111111110000000000000000000000111111111111111111111111111111111000011011111101111111000011000000
1111111111110000000000000000000111111111111111111111111111111111111100001111111100000111000001000000
1111111111100000000000000000000111111111111111111111111111111111111101001111111110111011100000000000
1111111111100000000000000000000011111111111111111111111111111111111000011111111111111111100000000000
1111111111110000000000000000000000111111111111111111111111111111111000111000111111111111000000000000
1111111111110000000000000000000000001111111111111111111111111111001000111001111111111101000000000000
1111111111110000000000000000000000000000011111111111111111110001111111111011111111111111000000000000
1111111111110000000000000000000000000000000000000111111111001111111111111111111111111100000000000000
1111111111111000000000000000000000001111100000000001111101111111111111111111111111111111000000000000
1111111111111000000000000000000000000000111000000000011100111111100111111111111111111110000000000000
1111111111111100000000000000000000000000000000000000000000011110011111111111111111111111010000000000
1111111111111100000000000000000000000000000000000000000000001111111111111111111111111111001000000000
1111111111111000000000000000000000000000000000000000000000000000111111111111111111111111000100000000
1111111111111000000000000000000000000000000000000000000000000000111111111111111111111111000000000000
1111111111111000000000000000000000000000000000000000000000000001111111111111111111111111100000000000
1111111111000000000000000000000000000000000000000000000000000111111111111111111111111111110000000000
1111111111110000000000000000000000000000000000000000000000111111111111111111111111111110110000000000
1111111111110000000000000000000000000000000000000000000111111111111111111111111111111111110000000000
1111111111111000000000000000000000000000000000000000000000011111111111111111111111111111111000000000
1111111111111000000000000000000000000000000000000000000000000111111111111111111111111111111000000000
1111111111111000000000000000000000000000000000000000000000000011111111111111111111111111111000000000
1111111111111000000000000000000000000000000000000000000000000111111111111111111111111111111100000000
1111111111111000000000000000000000000000000000000000100000011111111111111111111111111111111101100000
1111111111111000000000000000000000000000000000000011001001111111111111111111111111111111111100000000
1111111111111100000000000000000000000000000000011100000011111111111111111111111111111111111111000000
1111111111111000000000000000000000000000000000100000000011100011111111111111111111111111111100000000
1111111111111000000000000000000000000000000001001110000000000011111111111111111111111111111100000000
1111111111111100000000000000000000111100000001001111100000000011111111111111111111111111111000000000
1111111111111000000000000000000111111110000000000010100000000001111111101111111111111111110000000000
1111111111111000000000000000000111111111000000011110000000010001000000101111111111111111110000000000
1111111111111000000000000000000011111111110000000000011010000000000000011111111111111111110000000000
1111111111111000000000000000000001111111110000000000000000000000000001101111111111111111100000000000
1111111111111000000000000000000011111111111100001100000000000000000010000011111111111111100000000000
1111111111111000000000000000000111111111100000011000000000000000000001000001111101111111100000000000
1111111111111000000000000000011111111111000001111000000000000000000001110100011100111111110100000000
1111111111111000000000000000011111111111110000110000000000000000000000000100010000011111110100000000
1111111111111000000000000010011111111110000001100000000000000000000000000000000000011111110000000000
1111111111110000000000000000000111111000000000001000000000000000000000000000000000011111100000000000
1111111111110000000000000000000000000000000000000000000000000000000000000000000000111111100000000000
1111111111110000000000000000000000000000000000000000000000000000000000000000000111001111100000000000
1111101111100000000000000000000000000000000000000000000000000000000000000000000001101111000000000000
1111000001100000000000000000000000000010000000000000000000000000000000000000000000011111000000000000
1111000001100000000000001100000000000000000000000000000000000000000000000000000000011111000000000000
1111000000000000000000000011000000000000000000000000000000000000000000000000000000001111000000000000
1111000000000000000000000000100000000000000000000000000000000000000000000000000000001111000000000000
1110000000000000000000000000000000000000000000000000000000000000000000000000000000000011000000000000
