100,100
0000000000000000000000000000000000000000000000000000000000000000000000000000000000000000000000000000
0000000000000000000000000000000000000000000000000000000000000000000000000000000000000000000000000000
0000000000000000000000000000000000000000000001110000000000000000000000000000000000000000000000000000
0000000000000000000000000000000000000000000011111110000000000100000000001111111111100000000000000000
0000000000000000000000000000000000000000000111111111100111111111000000111111111111000000000000000000
0000000000000000000000000000000000000000000111111111111111111111111111111111111110000000000000000000
0000000000000000000000000000000000000000000111111111111111111111111111111111111100000000000000000000
0000000000000000000000000000000000000000011111111111111111111111111111111111111000000000000000000000
0000000000000000000000000000000000000011111111111111111111111111111111111111111000000000000000000000
0000000000000000000000000000000000000111111111111111111111111111111111111111111100000000000000000000
0000000000000000000000000000000000001111111111111111111111111111111111111111111100000000000000000000
0000000000000000000000000000000000001111111111111111111111111111111111111111111100000000000000000000
0000000000000000000000000000000000001111111111111111111111111111111111111111111000000000000000000000
0000000000000000000000000000000000011111111111111111111111111111111111111111111000000000000000000000
0000000000000000000000000000000000011111111111111111111111111111111111111111111000000000000000000000
0000000000000000000000000000000010111111111111111111111111111111111111111111111000000000000000000000
0000000000000000000000000000000111111111111111111111111111111111111111111111111100000000000000000000
0000000000000000000000000000000111111111111111111111111111111111111111111111111100000000000000000000
0000000000000000000000000000000011111111111111111111111111111111111111111111111110000000000000000000
0000000000000000000000000000000111111111111111111111111111111111111111111111111111000000000000000000
0000000000000000000000000000001111111111111111111111111111111111111111111111111111000000000000000000
0000000000000000000000000000011111111111111111111111111111111111111111111111111111100000000000000000
0000000000001111110000000001111111111111111111111111111111111111111111111111111111110000000000000000
0000000000001111111100000000111111111111111111111111111111111111111111111111111111111000000000000000
0000000000000111111111100011111111111111111111111111111111111111111111111111111111111000000000000000
0000000000000000111111111111111111111111111111111111111111111111111111111111111111110000000000000000
0000000000000000001111111111111111111111111111111111111111111111111111111111111111110000000000000000
0000000000000000000001111111111111111111111111111111111111111111111111111111111111110000000000000000
0000000000000000000000111111111111111111111111111111111111111111111111111111111111111000000000000000
0000000000000000000000011111111111111111111111111111111111111111111111111111111111111100000000000000
0000000000000000000000001111111111111111111111111111111111111111111111111111111111111100000000000000
0000000000000000000000001111111111111111111111111111111111111111111111111111111111111111100000000000
0000000000000000000001111111111111111111111111111111111111111111111111111111111111111111100000000000
0000000000000000000001111111111111111111111111111111111111111111111111111111111111111111100000000000
0000000000000110000011111111111111111111111111111111111111111111111111111111111111111111100000000000
0000000000000111111111111111111111111111111111111111111111111111111111111111111111111111110000000000
0000000000000001111111111111111111111111111111111111111111111111111111111111111111111111111100000000
0000000000000000111111111111111111111111111111111111111111111111111111111111111111111111111100000000
0000000000000001111111111111111111111111111111111111111111111111111111111111111111111111111000000000
0000000000000011111111111111111111111111111111111111111111111111111111111111111111111111111100000000
0000000000000111111111111111111111111111111111111111111111111111111111111111111111111111111110000000
0000000000001111111111111111111111111111111111111111111111111111111111111111111111111111111111110000
0000001111111111111111111111111111111111111111111111111111111111111111111111111111111111111111110000
0000001111111111111111111111111111111111111111111111111111111111111111111111111111111111111111110000
0000011111111111111111111111111111111111111111111111111111111111111111111111111111111111111111110000
0000111111111111111111111111111111111111111111111111111111111111111111111111111111111111111111110000
0001111111111111111111111111111111111111111111111111111111111111111111111111111111111111111111111000
0000111111111111111111111111111111111111111111111111111111111111111111111111111111111111111111111000
0000011111111111111111111111111111111111111111111111111111111111111111111111111111111111111111111000
0000001111111111111111111111111111111111111111111111111111111111111111111111111111111111111111111000
0000000010111111111111111111111111111111111111111111111111111111111111111111111111111111111111111000
0000000000011111111111111111111111111111111111111111111111111111111111111111111111111111111111110000
0000000000111111111111111111111111111111111111111111111111111111111111111111111111111111111111100000
0000000000011111111111111111111111111111111111111111111111111111111111111111111111111111111111100000
0000000000001011111111111111111111111111111111111111111111111111111111111111111111111111111111100000
0000000000000011111111111111111111111111111111111111111111111111111111111111111111111111111111100000
0000000000000001111111111111111111111111111111111111111111111111111111111111111111111111111111100000
0000000000000001111111111111111111111111111111111111111111111111111111111111111111111111111111100000
0000000000000111111111111111111111111111111111111111111111111111111111111111111111111111111111100000
0000000000000111111111111111111111111111111111111111111111111111111111111111111111111100000000000000
0000000000001111111111111111111111111111111111111111111111111111111111111111111111111000000000000000
0000001111111111111111111111111111111111111111111111111111111111111111111111111111111000000000000000
0000011111111111111111111111111111111111111111111111111111111111111111111111111111111000000000000000
0000000111111111111111111111111111111111111111111111111111111111111111111111111110000000000000000000
0000000111111111111111111111111111111111111111111111111111111111111111111111111100000000000000000000
0000111111111111111111111111111111111111111111111111111111111111111111111111111100000000000000000000
0000111111111111111111111111111111111111111111111111111111111111111111111111110000000000000000000000
0000111111111111111111111111111111111111111111111111111111111111111111111111100000000000000000000000
0000111111111111111111111111111111111111111111111111111111111111111111111111100000000000000000000000
0000111111111111111111111111111111111111111111111111111111111111111111111111100000000000000000000000
0000000000111111111111111111111111111111111111111111111111111111111111111111100000000000000000000000
0000000000011111111111111111111111111111111111111111111111111111111111111111111000000000000000000000
0000000000001111111111111111111111111111111111111111111111111111111111111111111000000000000000000000
0000000000000110111111111111111111111111111111111111111111111111111111111111111100000000000000000000
0000000000000000011111111111111111111111111111111111111111111111111111111111111100000000000000000000
0000000000000000111111111111111111111111111111111111111111111111111111111111111110000000000000000000
0000000000000000001111111111111111111111111111111111111111111111111111111111111110000000000000000000
0000000000000000000000010001111101111111111111111111111111111111111111111111111110000000000000000000
0000000000000000000000000001000000001111111111111111111111111111111111111111111110000000000000000000
0000000000000000000000000000000000000011111111111111111111111111111111111111111110000000000000000000
0000000000000000000000000000000000000001111111111111111111111111111111111111111110000000000000000000
0000000000000000000000000000000000000000111111111111111111111111111111111111111111000000000000000000
0000000000000000000000000000000000000000011111111111111111111111111111111111111111000000000000000000
0000000000000000000000000000000000000000000111111111111111111111111111111111111111000000000000000000
0000000000000000000000000000000000000000000000011001111111111111111111111111111111000000000000000000
0000000000000000000000000000000000000000000000001000111111111111111111111111111111100000000000000000
0000000000000000000000000000000000000000000000000000001111111111111111111111111111000000000000000000
0000000000000000000000000000000000000000000000000000001101111111111111111111111110000000000000000000
0000000000000000000000000000000000000000000000000000000000011111111111111111111100000000000000000000
0000000000000000000000000000000000000000000000000000000001111111111111111111011000000000000000000000
0000000000000000000000000000000000000000000000000000000000101111111111111111000000000000000000000000
0000000000000000000000000000000000000000000000000000000000001111111111111000000000000000000000000000
0000000000000000000000000000000000000000000000000000000000001111111111100000000000000000000000000000
0000000000000000000000000000000000000000000000000000000000000111111000000000000000000000000000000000
0000000000000000000000000000000000000000000000000000000000000111111100000000000000000000000000000000
0000000000000000000000000000000000000000000000000000000000000011111100000000000000000000000000000000
0000000000000000000000000000000000000000000000000000000000000011110000000000000000000000000000000000
0000000000000000000000000000000000000000000000000000000000000011100000000000000000000000000000000000
0000000000000000000000000000000000000000000000000000000000000000000000000000000000000000000000000000
0000000000000000000000000000000000000000000000000000000000000000000000000000000000000000000000000000
