50,50
00000000000000000000000000000000000000000000000000
11000000000000000000000000000000000000000000000000
11000000000000000000000000000000000000000100000000
11000000000000000000000000000000000000001111000000
11110000000000000000000000000000000000000111000000
11110000000000000000000000000000000000000111000000
11111000000000000000000000000000000000000111000000
11111000000000000000000000000000000000011111000000
11111000000000000000000000000000000111111111100000
11111000000000000000000000000000101111111110110000
11111000000000000000000000000001111111111111110000
11111000000000000000000000000011111111111110110000
11111000000000000000000000000100011111111011011000
11111000000000000000000000001000011111110011111000
11101000000000000000001111100010001111110110101100
11101100001111111111111111110000000001111111000100
11100100000000111111111111110000000000011000001100
11100000000000011111111111100000000000000000111000
11110000000000000011111110000000000000000011111000
11100000000000000001111100000000000000000001111100
11110000000000000000000000000000000000000001111100
11110000000000000000000000000000000000000000111100
11110000000000000000000000000000000000000010000000
11111100000000000000000000011111100000000000000000
11111100000000000000000000111111111110011000000000
11111100000000000000000000011111111001100000000000
11111100000000000000000011111111110001110110000000
11111100000000001111111111111111100001110011001000
11111100000000001111111111111111110011111111000000
11111100000000000011111111111111101100111111000000
11111100000000000000010011111011111101111110000000
11111110000000000001100000110111111111111110000000
11111110000000000000000000000011111111111111100000
11111100000000000000000000000000111111111111000000
11111000000100000000000000000001111111111111100000
11111100000000000000000000011111111111111111100000
11111110000000000000000000000011111111111111100000
11111110000000000000000000000001111111111111110000
11111110000000000000000001011111111111111111111000
11111110000000000000000000001101111111111111110000
11111110000000000010000011000001111111111111100000
11111110000000001111000010001101010011111111100000
11111110000000001111100000000000000011111111100000
11111110000000001111110000000000001001111111000000
11111110000000111111110100000000000010100111110000
11111100000000011110000100000000000000000111000000
11111100000000000000000000000000000000011011000000
11000100000000000000000000000000000000000111000000
11000000000001000000000000000000000000000011000000
11000000000000000000100000000000000000000001000000
